圣乐	sheng yue
聖樂	sheng yue
校注	jiao zhu
校註	jiao zhu
校刻	jiao ke
方略	fang lüe
评传	ping zhuan
評傳	ping zhuan
点校	dian jiao
點校	dian jiao
长编	chang bian
長編	chang bian
康乾	Kang Qian
全传	quan zhuan
全傳	quan zhuan
乾嘉	Qian Jia
基督徒	Jidutu
基督教	Jidu jiao
基督	Jidu
明朝	Ming chao
清朝	Qing chao
中的	zhong de
校释	jiao shi
校釋	jiao shi
重点	zhong dian
重點	zhong dian
戏曲	xi qu
戲曲	xi qu
戏典	xi dian
戯典	xi dian
校笺	jiao jian
校箋	jiao jian
儒藏	ru zang
重版	chong ban
校点	jiao dian
校點	jiao dian
辑校	ji jiao
輯校	ji jiao
校補	jiao bu
校补	jiao bu
藏书	cang shu
蔵書	cang shu
堾	chun
祮	gao
軚	dai
㸁	han
枊	ang
荾	sui
五代	Wu dai
北宋	Bei Song
南宋	Nan Song
西夏	Xi Xia
洪武	Hongwu
建文	Jianwen
永樂	Yongle
洪熙	Hongxi
宣德	Xuande
正統	Zhengtong
景泰	Jingtai
天順	Tianshun
成化	Chenghua
弘治	Hongzhi
正德	Zhengde
嘉靖	Jiajing
隆慶	Longqing
萬曆	Wanli
泰昌	Taichang
天啟	Tianqi
崇禎	Chongzhen
順治	Shunzhi
康熙	Kangxi
雍正	Yongzheng
乾隆	Qianlong
嘉慶	Jiaqing
道光	Daoguang
咸豐	Xianfeng
同治	Tongzhi
光緒	Guangxu
光緖	Guangxu
宣統	Xuantong
須彌	Xumi
